NO assets/textures/n.png
SO assets/textures/s.png
WE assets/textures/w.png
EA assets/textures/e.png

F 0,51,51
C 53,81,92

111111111111111111111111111111
100000000000000000001111111111
101110111000000000011000000011
100000000000000000101101111111
111111101111101111101100000001
100000000001101000001101001101
101000000001000000001111001101
1010111001110N1100101100000101
100010000000000001001101001101
111110111011011101001100000001
100000001000000001001111001101
111111101101101111100111100001
111100000000000000111110111111
111111111111111111111111111111
