NO assets/textures/n.png
SO assets/textures/s.png
WE assets/textures/w.png
EA assets/textures/e.png

F 0,0,0
C 53,81,92

111111111111111111111111111111
100000000000000000001111111111
101111D11100000000001100000001
100000000000000000101101111111
1111111D1111101111101100000001
100000000001101000001101001101
101000000001000000001111001101
101000N00001000000001111001101
101011100111D11100101100000101
100010000000000001001101001101
111110111011D11101001100000001
100000001000000001001111001101
1111111011D1101111100000000001
10000000000000000011111D111111
111111111111111111111111111111
