NO assets/textures/f.png
SO assets/textures/b.png
WE assets/textures/c.png
EA assets/textures/e.png

F 32,32,32
C 204,255,255

        1111111111111111111111111
        1000000000110000000000001
        1011000001110000000000001
        1001000000000000000000001
111111111011000001110000000000001
100000000011000001110111000111111
11110000000000011100000010001
11110001000000000001010010001
110000001N0100000000000010001
10000000000000000000000010001
11111111111111111111111111111
