NO assets/textures/n.png
SO assets/textures/s.png
WE assets/textures/w.png
EA assets/textures/e.png

F 32,32,32
C 204,255,255

11111111111111111 11111111
1000000000110000000000001
1011000001110000000000001
100100000000000000000000111111111
111111111011000001110000000000001
10000000000E000001110111000111111
11110000000100011100000010001
11110001000000000001010010001
11111111111111111111111111111
