NO assets/textures/n.png
SO assets/textures/s.png
WE assets/textures/w.png
EA assets/textures/e.png

F 0,0,0
C 53,81,92

        1111111111111111111111111
        1000000000110000000000001
        1011000001110000000000001
        1001000000000000000000001
111111111011000001110000000000001
100000000011000001110111111111111
11110100011100011100000010001
11110100111101011101010010001
10000000110001011100000010001
10000000000011D11000000100001
10000000000000N001101010010001
1100000111010101111101110000111
11110111 1110101 101111010001
11111111 1111111 111111111111
