NO assets/textures/n.png
SO assets/textures/s.png
WE assets/textures/w.png
EA assets/textures/e.png

F 0,0,0
C 53,81,92


111111111111111111111111111111
100000000000000000000000001111
10111011111D110000011000000011
100000000D00D00000000001111111
11111110111D11111D110010000001
100000000001101000000001001101
101000000011000000000011001101
1010111001N1011100100000000101
100010000000000001000001001101
111110111011011101000000000001
100000001000000000000011001101
111D111011011011D1100111100001
100000000000000000111110111111
111111111111111111111111111111
