1111111111111111111111111
1000000000110000000000001
1011000001110000000000001
10010000000000000N0000001
1111111110110000011100001
1000000000010000011101111
1111011111101101110000001
1111011111111101110101001
1100000011011101110000001
1000000000000000110000001
1000000000000000110101001
1100000111010101111101111
11110111 1110101 10111101
11111111 1111111 11111111
