111111111111
1N0100000001
100100000001
100000000001
110000000001
110100001111
110100001111
100000000001
100000000001
100000000001
100000000001
111111111111
