NO                      121212121211212313132                     
EA           ./path_to_ the_south_texture hfhfh
WE ./path_to_the_west_texture 
EA     121323


F           1,2,3
F           2,5,2

11111
11111          11
111S1
11111