SO jdgsjkf
EA kls
WE dlskhfjds
NO kjdhs

F 1,2,3
C 1,2,3




111
1101111
111111