                                    NO                      1212121212--94/-=/-547677/**/++11212313132                     
EA ./path_to_ the_south_texture hfhfh
WE ./path_to_the_west_texture 
SO ./path_to_the_west_texture 

C        
F          1,5,2

111111
11