111111111111
101000000001
100100000001
10000N000001
110001000001
110101001111
110100001111
100000000001
100000000001
100000000001
100000000001
111111111111
