111111111111
100100000001
100100000001
100000000001
1100N0000001
110100001111
110100001111
100000000001
100000000001
100000000001
100000000001
111111111111
